XXXXXXXXXXXXXXXXXXXXXXXXXXXXXXXXXXXXXXXXXXXXXXXXXXXXXXXXXXXXXXXXXXXX
XXXXXXXXXXXXXXXXXXXXXXXXXXXXXXXXXXXXXXXXXXXXXXXXXXXXXXXXXXXXXXXXXXXX
XX.............................................................{..XX
XX................................................................XX
XX................................................................XX
XX................................................................XX
XX................................................................XX
XX................................................................XX
XX................................................................XX
XX................................................................XX
XXT.........................XXXXXXXXXXXXXXXXXXXXXXXXXXXXXXXXXXXXXXXX
XX..........................XXXXXXXXXXXXXXXXXXXXXXXXXXXXXXXXXXXXXXXX
XX..........................XXXXXXXXXXXXXXXXXXXXXXXXXXXXXXXXXXXXXXXX
XX.............................................................{..XX
XX................................................................XX
XX................................................................XX
XX................................................................XX
XX................................................................XX
XX................................................................XX
XX................................................................XX
XX................................................................XX
XX................................................................XX
XX................................................................XX
XX................................................................XX
XX................................................................XX
XX................................................................XX
XX................................................................XX
XX...@............................................................XX
XX................................................................XX
XX................................................................XX
XXXXXXXXXXXXXXXXXXXXXXXXXXXXXXXXXXXXXXXXXXXXXXXXXXXXXXXXXXXXXXXXXXXX
XXXXXXXXXXXXXXXXXXXXXXXXXXXXXXXXXXXXXXXXXXXXXXXXXXXXXXXXXXXXXXXXXXXX