XXXXXXXXXXXXXXXXXXXXXXXXXXXXXXXXXXXXXXXXXXXXXXXXXXXXXXXXXXXXXXXXXXXX
XXXXXXXXXXXXXXXXXXXXXXXXXXXXXXXXXXXXXXXXXXXXXXXXXXXXXXXXXXXXXXXXXXXX
XX................................................................XX
XX................................................................XX
XX................................................................XX
XX.....@..........................................................XX
XX................................................................XX
XX................................................................XX
XX................................................................XX
XX................................................................XX
XX................................................................XX
XX................................................................XX
XX................................................................XX
XX................................................................XX
XX................................................................XX
XX................................................................XX
XX................................................................XX
XX................................................................XX
XX................................................................XX
XX................................................................XX
XX................................................................XX
XX................................................................XX
XX................................................................XX
XX................................................................XX
XX................................................................XX
XX................................................................XX
XX................................................................XX
XX................................................................XX
XX................................................................XX
XX................................................................XX
XXXXXXXXXXXXXXXXXXXXXXXXXXXXXXXXXXXXXXXXXXXXXXXXXXXXXXXXXXXXXXXXXXXX
XXXXXXXXXXXXXXXXXXXXXXXXXXXXXXXXXXXXXXXXXXXXXXXXXXXXXXXXXXXXXXXXXXXX